50,0,0,0,0,0,0,0,0,0,0,0,0,0,0,0,0,0,0,0,0,0,0,0,0,0,0,0,0,0,0,0,0,0,0,0,0,0,0,0,0,0,0,0,0,0,0,0,0,0,0,0,0,0,0,0,0,0,0,0,0,0,0,0,50
50,0,0,0,0,0,0,1,11,1,0,0,0,0,0,1,0,0,0,0,0,1,11,11,11,11,11,11,11,11,11,11,11,11,11,11,11,11,11,1,0,0,0,1,11,1,0,0,0,0,4,0,0,0,0,0,0,0,0,0,0,0,0,0,50
50,0,0,0,0,0,0,1,11,1,0,0,0,0,0,1,0,0,0,0,0,1,11,11,11,11,11,11,11,11,11,11,11,11,11,11,11,11,11,1,0,0,0,1,11,1,0,0,0,0,4,0,0,0,0,0,0,0,0,0,0,0,0,0,50
50,0,0,0,0,0,0,1,11,1,0,0,0,0,0,1,0,0,0,0,0,1,11,1,1,1,1,1,1,1,1,1,1,1,1,1,1,1,11,1,0,0,0,1,1,1,0,0,0,0,4,0,0,0,0,0,0,0,0,0,0,0,0,0,50
50,0,0,0,0,0,0,1,11,1,0,0,0,0,0,1,0,0,0,0,0,1,11,1,0,0,0,0,30,0,30,0,0,0,30,2,0,1,1,1,0,0,0,0,0,0,0,0,0,0,4,0,0,0,0,0,0,0,0,0,0,0,0,0,50
50,0,0,0,0,0,0,1,1,1,0,0,0,0,0,4,0,0,0,0,0,1,1,1,0,0,0,0,0,0,0,0,0,0,0,1,2,0,1,1,0,0,0,30,2,0,0,0,0,0,4,0,0,0,0,0,0,0,0,0,0,0,0,0,50
50,0,0,0,0,0,0,0,0,0,0,0,0,0,0,4,0,0,0,0,0,0,0,0,0,0,0,0,0,0,0,0,0,0,0,4,1,2,0,1,0,0,0,0,1,1,1,1,0,0,1,0,0,0,1,1,1,1,0,0,0,0,0,0,50
50,0,0,0,0,0,0,0,30,2,0,0,0,0,0,4,0,0,0,0,0,0,30,0,0,0,0,0,3,0,3,0,0,0,3,4,1,1,2,0,0,0,0,0,4,0,0,9,0,9,1,0,0,0,1,11,11,1,0,0,0,0,0,0,50
50,0,0,0,0,0,0,0,0,1,1,1,1,0,0,1,0,0,0,0,0,0,0,1,1,1,1,1,1,20,1,20,1,1,1,1,1,1,1,2,0,0,0,3,4,0,0,1,1,1,1,0,0,0,1,11,11,1,0,0,0,0,0,0,50
50,0,0,0,0,0,0,0,0,4,0,0,9,0,9,1,0,0,0,0,0,0,0,4,1,11,11,11,1,0,0,0,1,11,11,1,1,1,1,1,1,1,1,0,4,0,2,0,2,0,1,0,0,0,1,11,11,1,0,0,0,0,0,0,50
50,0,0,0,0,0,0,0,3,4,0,0,1,1,1,1,1,0,0,0,0,0,3,4,1,11,11,11,1,0,0,0,1,11,11,1,0,0,0,0,0,0,0,3,4,1,1,1,1,0,1,0,0,0,1,11,11,1,0,0,0,0,0,0,50
50,0,0,0,0,0,0,0,0,4,0,2,0,2,0,2,0,1,0,0,0,0,0,4,1,11,11,11,1,0,0,0,1,11,11,1,0,0,0,0,0,0,0,0,4,0,0,9,0,9,1,0,3,0,1,11,11,1,0,0,0,0,0,0,50
50,0,0,0,0,0,0,0,3,4,1,1,1,1,1,1,2,0,1,0,0,0,3,4,1,1,11,11,1,0,3,0,1,11,11,1,0,0,0,0,0,0,0,3,4,0,0,1,1,1,1,0,0,0,1,1,1,1,0,0,0,0,0,0,50
50,0,0,0,0,0,0,0,0,4,1,11,11,11,11,1,1,2,0,1,0,0,0,0,0,1,1,1,1,0,0,0,1,1,1,1,0,0,0,0,0,0,0,0,4,0,2,0,2,0,2,0,3,2,0,2,0,2,0,0,0,0,99,0,50
50,0,0,0,0,0,0,0,3,4,1,11,11,11,11,11,1,1,2,2,0,0,3,0,2,0,2,0,2,0,3,2,0,2,0,2,0,0,0,0,0,0,0,3,4,1,1,1,1,1,1,1,1,1,1,1,1,1,1,1,1,1,1,1,1
1,1,1,1,1,1,1,1,1,1,1,11,11,11,11,11,11,1,1,1,1,1,1,1,1,1,1,1,1,1,1,1,1,1,1,1,1,1,1,1,1,1,1,1,1,1,11,11,11,11,11,11,11,11,11,11,11,11,11,11,11,11,11,11,11
